 █████ █████ ███ █████████ █████████████ 
█.....█.....█...█.........█.............█
█.█████.███.█.█.█.███████.█.███████.███.█
█.....█...█.█.█...█.█.....█.█...█...█.█.█
█.███.███.█.█.█████.█.███.█.███.█.███.█.█
█...█.....█...█.....█...█.█.....█...█...█
 ██.███████████.███.███.███████.███.████ 
█.█.█...........█.█.█.█.█.....█.█.█.....█
█.█.███.█████████.█.█.█.█.███.█.█.█████.█
█.█...█.█...█.......█.█...█.█...█.....█.█
█.███.█.█.█.█.███████.█████.███████.███.█
█.....█...█.█.█.....................█...█
 ████.█.███.█.█████.███████████.█████.██ 
█...█.█...█.█.....█.......█.....█...█...█
█.█.█.███.█.█████.███████.█.█████.█.███.█
█.█.█...█.█.█...█...█...█.█.█.....█.█...█
█.█.███.███.█.█.███.█.█.█.█.█.█████.█.██ 
█.█.█.....█.█.█...█...█.█.█.█.█.....█...█
█.█.█████.█.█.███.█.███.█.█.█.█████.█.█.█
█.█...█...█...█...█.█X█.█.█.█.....█.█.█.█
█.███.███.█████.█.███.█.█.█.█████.█.███.█
█...█...█.......█.█...█...█.█.....█.....█
 ██.███.███████████.███████.█.█████████.█
█...█.█.............█.....█.█.........█.█
█.███.█████████████████.█.█.█████████.█.█
█...█.................█.█.█.....█...█.█.█
 ██.███████████████.█.█.███████.█.█.█.█.█
█.█...█.........█...█.█.......█.█.█.█.█.█
█.███.█.███████.█.███.█████.█.█.█.█.█.█.█
█...█...█.█...█...█.█.....█.█.█.█.█.█.█.█
█.█.█████.█.█.█████.█████.█.█.█.█.█.█.██ 
█.█.....█...█.█.........█.█.█.█...█.█...█
█.█████.█.███.█.█.███████.█.█.█████.███.█
█o█.....█...█...█.....█...█.█.........█.█
 ██.███.███.█████████.█.███████████████.█
█...█.....█...█.......█.......█.......█.█
█.███████.███.█.█████████████.█.█████.█.█
█.█.....█...█.█.█...█.......█.█...█.█.█.█
█.█.███.█████.█.█.█.█.█.█████.███.█.█.█.█
█.....█.......█...█...█...........█.....█
 █████ ███████ ███ ███ ███████████ █████ 
